O-O-O-O-O-O-O
O-O-B-B-B-O-O
O-E-5-6-7-E-O
O-E-B-B-B-E-O
O-F-F-F-F-F-O