O-O-O-O-O-O-O
O-B-B-B-B-B-O
O-3-B-B-B-3-O
O-B-B-B-B-B-O
O-B-B-B-B-B-O
O-F-F-F-F-F-O