O-O-O-O-O-O-O
O-O-B-B-B-O-O
O-E-B-4-B-E-O
O-E-B-B-B-E-O
O-F-F-F-F-F-O