O-O-O-O-O-O
O-T-T-T-T-O
O-T-T-T-T-O
O-B-B-B-B-O
O-F-F-F-F-O